Алхимик - Пауло Коэльо
Ангелы и демоны - Дэн Браун
Вино из одуванчиков - Рей Брэдбери
Властелин колец - Джон Р. Р. Толкин
Властелин мира - Джон Рональд Руэл Толкин
Война и мир - Лев Толстой
Война миров - Герберт Уэллс
Гарри Поттер и Дары Смерти - Джоан Роулинг
Гарри Поттер и методы рационального мышления - Элиезер Юдковски
Гиперион - Дэн Симмонс
Гордость и предубеждение - Джейн Остин
Двенадцать стульев - Илья Ильф, Евгений Петров
Дом, в котором... - Мария Джоао Карвалью
Дракула - Брэм Стокер
Звёздные короли - Бернар Вербер
Зеленая миля - Стивен Кинг
Игра престолов - Джордж Мартин
Маленькие женщины - Луиза Мэй Олкотт
Мастер Гарри Поттер и Кубок огня - Джоан Роулинг
Мастер Гарри Поттер и Принц-полукровка - Джоан Роулинг
Мастер Гарри Поттер и орден Феникса - Джоан Роулинг
Мастер Гарри Поттер и узник Азкабана - Джоан Роулинг
Мёртвые души - Николай Гоголь
Над пропастью во ржи - Джером Сэлинджер
Основной инстинкт - Джон Коттер
Остров доктора Моро - Герберт Уэллс
Повелитель мух - Уильям Голдинг
Портрет Дориана Грея - Оскар Уайльд
Последнее королевство - Бернард Корнуэлл
Последний из могикан - Джеймс Фенимор Купер
Разумный инвестор - Бенджамин Грэхем
Сад Гетсиманский - Леонид Леонов
Старик и море - Эрнест Хемингуэй
Триумфальная арка - Эрих Мария Ремарк
Фаренгейт 451 - Рей Брэдбери
Хижина дяди Тома - Харриет Бичер-Стоу
Цветы для Элджернона - Дэниел Киз
Шантарам - Грегори Дэвид Робертс
Шантарам - Грегори Дэвид Робертс
